[Options]
AddToInfo=1
Caption=Информация
CityName=Bucarest
;StringToAdd='  '

[M 1]
Dristor=Находится на пересечении бульвара Camil Ressu и улицы Stefan cel Mare.\n\nИнтересно, что поезда оборачиваются на самой станции. Поэтому приходящие поезда каждый раз меняют платформу. Так как поезда подолгу стоят, прежде чем отправиться, можно даже застать два поезда, которые вместе наполняются пассажирами.\n\nСтанция открыта в августе 1989г.
Piata Muncii=Площадь труда.\nВыход на улицу Stefan Cel Mare и бульвар Bassarabia.\n\nСтанция открыта в августе 1989г.
Iancului=Выход на улицы Stefan Cel Mare и Iancului.\n\nСтанция открыта в августе 1989г.
Obor=Выход к одноименному рынку и крупному универмагу.\nВыход на улицы Stefan Cel Mare и Moshilor.\n\nСтанция открыта в августе 1989г.
Stefan cel Mare=Выход на улицы Stefan Cel Mare и Tunari.\n\nStefan Cel Mare - знаменитый румынский полководец.\n\nСтанция открыта в августе 1989г.
Piata Victoriei=Площадь Победы, одна из центральных площадей Бухареста.\nНаходится на пересечении бульвара Aviatorilor, бульвара L.Catargiu и улицы Stefan cel Mare.\n\nСтанция открыта в августе 1989г.
Gara de Nord=Выход на проспект Grivitei.\nВыход к центральному железнодороному вокзалу.\n\nПоезда различаются по надписи на табло головного вагона.\n\nСтанция открыта в декабре 1987г.
Basarab=Выход на проспект Grivitei.\nВыход к Бессарабскому вокзалу.\n\nСтанция открыта в декабре 1987г.
Crangasi=Выход на одноименную площадь и улицу Berceni.\n\nСтанция открыта в декабре 1984г.
Petrache Poenaru=Выход на улицу Virtutii.\n\nСтанция открыта 16 ноября 1979г.
Grozavesti=Выход на бульвар V.Milea.\n\nСтанция открыта 16 ноября 1979г.
Eroilor=Выход на бульвар Regina Margherita.\nПересадочный узел на линию М 3.\nНа станции находятся 3 пути (одна островная и две боковые платформы), отдельно прибывают поезда, следующие на Preciziei.\n\nСтанция открыта 16 ноября 1979г.
Izvor=Переводится как "Родник".\n\nСтанция открыта 16 ноября 1979г.
Piata Unirii=Площадь Воссоединения, одна из центральных площадей Бухареста.\nВыход на бульвар Bradanu и бульвар Regina Maria.\nПересадка на линию М 2.\n\nСтанция открыта 16 ноября 1979г.
Timpuri Noi=Выход на проспект Stefan Voda.\nПереводится как "Новые времена".\n\nСтанция открыта 16 ноября 1979г.
Mihai Bravu=Выход на проспект Vacaresti.\n\nСтанция открыта в декабре 1981г.
Dristor2=Находится на пересечении бульвара Camil Ressu и улицы Stefan cel Mare.\nПересадка на станцию Dristor.\n\nПолучается что-то вроде Московской Кольцевой линии.\n\nСтанция открыта в декабре 1981г.
Nicolae Grigorescu=Выход на бульвар Th.Pallady.\n\nСтанция открыта в декабре 1981г.
Titan=Выход к одноименному заводу.\n\nСтанция открыта в декабре 1981г.
Costin Georgian=Выход на улицу Baba Novac.\n\nСтанция открыта в декабре 1981г.
Republica=Выход на бульвар Bassarabia.\n\nСтанция открыта в декабре 1981г.
Pantelimon=Выход на улицу Pantelimon.\n\nСтанция открыта в январе 1990г.

[M 2]
Pipera=Выход на бульвар D.Pompei.\nВыход к индустриальному району.\n\nСтанция открыта в октябре 1987г.
Aurel Vlaicu=Находится на пересечении бульвара D.Pompei и улицы B.Vacarescu.\n\nСтанция открыта в октябре 1987г.
Aviatorilor=Выход на бульвар Aviatorilor.\nМежду Aurel Vlaicu и Aviatorilor находится зона посольств.\n\nСтанция открыта в октябре 1987г.
Piata Victoriei=Площадь Победы, одна из центральных площадей Бухареста.\nНаходится на пересечении бульвара Aviatorilor, бульвара L.Catargiu и улицы Stefan cel Mare. Пересадка на линию М 1.\n\nСтанция открыта в октябре 1987г.
Piata Romana=Римская Площадь, одна из центральных площадей Бухареста.\nВыход на бульвар L.Catargiu.\n\nСтанция открыта в октябре 1987г.
Universitatii=Выход к старейшему и знаменитому университету Бухареста (и Румынии).\nНаходится на пересечении бульвара Regina Margherita и бульвара Bradanu.\n\nСтанция открыта в октябре 1987г.
Piata Unirii=Площадь Воссоединения, одна из центральных площадей Бухареста.\nВыход на бульвар Bradanu и бульвар Regina Maria.\nПересадка на линию М 1.\n\nСтанция открыта в январе 1986г.
Tineretului=Выход на бульвар Bradanu, бульвар Marasesti и улицу Serban Voda.\n\nСтанция открыта в январе 1986г.
Eroii Revolutiei=Выход на бульвар Bradanu и улицу Oltenitei.\nПереводится как "Герои Революции".\n\nСтанция открыта в январе 1986г.
Constantin Brancoveanu=Выход на улицу Oltenitei.\n\nСтанция открыта в январе 1986г.
Piata Sudului=Находится на пересечении бульвара Al.Obregia, проспекта Vacaresti и улицы Oltenitei.\n\nСтанция открыта в январе 1986г.
Aparatorii Patriei=Выход на улицу Berceni.\n\nСтанция открыта в январе 1986г.
Dimitrie Leonida=Выход на улицу Berceni.\n\nСтанция открыта в январе 1986г.
Berceni=Выход на улицу Berceni. Выход к депо линии М 2.\n\nСтанция открыта в январе 1986г.
                                                                                                                                                                                                                                                                                                                                                                                                                                                                                                                                                                                                                                                                                                                                                                                                                                                                                                                                                                  
[M 3]
Eroilor=Выход на бульвар Regina Margherita.\nПересадочный узел на линию М 1. На станции находятся 3 пути (одна островная и две боковые платформы), отдельно прибывают поезда следующие на Preciziei.\n\nСтанция открыта в августе 1983г.
Politehnica=Выход на бульвар Regina Margherita и на бульвар Iuliu Maniu.\nВыход к политехническому университету.\n\nСтанция открыта в августе 1983г.
Lujerului=Выход на бульвар Regina Margherita.\nПереводится как "Народная армия".\n\nСтанция открыта в августе 1983г.
Gorjului=Выход на бульвар Regina Margherita.\n\nСтанция открыта в 1991г.
Pacii=Выход на бульвар Regina Margherita.\nПереводится как "Мир".\n\nСтанция открыта в августе 1983г.
Preciziei=Выход на бульвар Timisiora.\nВыход к индустриальному району.\n\nСтанция открыта в августе 1983г.
Nicolae Grigorescu=Станция открыта в декабре 1981г.

[M 4]
Gara de Nord=Выход на проспект Grivitei.\nВыход к центральному железнодороному вокзалу и пересадка на четвёртую линию. Станция с двумя боковыми платфоpмами, поезда различаются по надписи на табло головного вагона.
Basarab=Выход на проспект Grivitei.\nВыход к Бессарабскому вокзалу.\n\nСтанция открыта в августе 1989г.
Grivita=Выход на проспект Grivitei.\n\nСтанция открыта в марте 2000г.
1 Mai=Выход на проспект Grivitei.\n\nСтанция открыта в марте 2000г.
Jiului=
Parc Bazilescu=
