[Options]
AddToInfo=1
Caption=Информация
CityName=Минск
;StringToAdd='  '

[Московская]
Центральная площадь=Нынешнея "Октябрьская".
Площадь Независимости=Нынешнея "Площадь Ленина".
Брестская=Станция расположится на Брестском шоссе, за кольцевой дорогой, в районе нынешней д. Щемыслица.
Малиновка=Станция будет находится на пересечении проспекта Дзержинского с улицей Есенина.
Юго-Западная=Станция будет находиться на пересечении проспекта Дзержинского с улицей Голубева (возле медуниверситета).
Михалово=Станция расположится на пересечении проспекта Дзержинского с улицей Гурского.\nОкончание строительства намечено на 2011 г.\nПри активном финансировании проекта со стороны Мингорисполкома возможно сокращение сроков строительства на 2 года.
Грушевка=Станция будет находится на пересечении проспекта Дзержинского с улицей Щорса.\nСрок ввода в эксплуатацию - 2011 г.\nПри активном финансировании проекта со стороны Мингорисполкома возможно сокращение сроков строительства на 2 года.
Борисовский тракт=Станция будет располагаться на пересечении проспекта Независимости с Минской кольцевой автомобильной дорогой.
Уручье=Станция расположится на пересечении проспекта Независимости с ул. Ложинской (в районе дома № 181 по просп. Независимости).
Армейская=Станция будет находится на пересечении проспекта Независимости с улицей Героев 120-й дивизии.
Военная академия=Станция будет находится на пересечении проспекта Независимости с ул. Фогеля.

[Автозаводская]
Виленская=Станция будет находится на пересечении ул. Притыцкого с Минской кольцевой автомобильной дорогой.
Кунцевщина=Нынешнея "Каменная Горка".
Западная=Нынешнея "Кунцевщина".
Кальварийская=Нынешнея "Молодёжная".
Раковская=Нынешнея "Фрунзенская".
Ляховская=Нынешнея "Первомайская".
Смоленская=Нынешнея "Пролетарская".
Шабаны=Станция будет находится на пересечении Партизанского проспекта с улицей Селицкого.

[Витебская]
Витебская=Станция будет находится на Логойском шоссе, за кольцевой дорогой, в районе посёлка Боровая.
Зелёный Луг=Станция будет находится на пересечении Логойского тракта с улицей Карбышева.
Улица Калиновского=Станция будет находится на пересечении Логойского тракта с улицей Калиновского.
Измайловская=Станция будет находится на пересечении улицы Богдановича с улицей Халтурина.
Площадь Бангалор=Станция будет находится на пересечении улицы Богдановича с улицей Сурганова.
Комаровская=Станция будет находится на пересечении улицы Богдановича с улицей Веры Хоружей.
Сторожёвка=Станция будет находится на пересечении улицы Богдановича с проспектом Машерова.
Татарская=Станция будет находится на пересечении проспекта Победителей с улицей Мельникайте.
Юбилейная площадь=Станция будет находится на пересечении улиц Мельникайте и Романовская Слобода.
Площадь Франтишка Богушевича=Станция будет находится на пересечении проспекта Дзержинского с улицей Клары Цеткин.
Привокзальная=Станция будет находится на пересечении улицы Бобруйская с улицей Кирова.
Аранская=Станция будет находится на пересечении улиц Маяковского и Аранская.
Проспект Рокоссовского=Станция будет находится на пересечении проспекта Рокоссовского с улицей Ванеева.
Серебрянка=Станция будет находится на пересечении проспекта Рокоссовского с улицей Плеханова.
Парк Грековой=Станция будет находится на пересечении  проспекта Рокоссовского с улицей Малинина.
Чижовка=Станция будет находится на пересечении улиц Ташкентская и Голодеда.

[Заславская]
Заславская=Станция будет находится на пересечении Заславского шоссе с улицей Парковая.
Ждановичи=Станция будет находится на пересечении улиц Тимирязева и Колесникова.
Олимпийская=Станция будет находится на пересечении проспекта Победителей с улицей Нарочанская.
Крупцы=Станция будет находится на пересечении проспекта Победителей с улицей Радужная.
Веснянка=Станция будет находится на пересечении проспекта Победителей с улицей Орловская.
Гвардейская=Станция будет находится на пересечении проспекта Победителей с улицей Гвардейская.
Переспа=Станция будет находится на пересечении проспекта Машерова с улицей Максима Богдановича.
Золотая Горка=Станция будет находится на пересечении проспекта Независимости с проспектом Машерова.
Парк Горького=Станция будет находится на пересечении улиц Первомайская и Пулихова.
Стадион "Динамо"=Станция будет находится на пересечении улиц Первомайская и Ленина.
Бобруйская=Станция будет находится на пересечении улиц Бобруйская и Ульяновская.
Сеножаны=Станция будет находится на пересечении улиц Воронянского и Жуковского.
Лошицкая=Станция будет находится на пересечении улицы Лейтенанта Кижеватова с улицей 2-я Лошица.
Слуцкое шоссе=Станция будет находится на пересечении улиц Лейтенанта Кижеватова и улицы Корженевского.

[Кольцевая]
Долгиновский тракт=Станция будет находится на пересечении улицы Орловская с Долгиновским трактом.
Улица Максима Богдановича=Станция будет находится на пересечении улицы Богдановича с улицей Сурганова.
Проспект Франциска Скорины=Станция будет находится на пересечении проспекта Независимости с улицей Сурганова.
Ботанический сад=Станция будет находится на пересечении улицы Академическая и переулка Козлова.
Долгобродская=Станция будет находится на пересечении улиц Олега Кошевого и Грицевца.
Экономический университет=Станция будет находится на пересечении проспекта Рокоссовского с улицей Ванеева.
Козыревская=Станция будет находится на пересечении улиц Маяковского и Денисовская.
Новомещанская=Станция будет находится на пересечении улиц Воронянского и Жуковского.
Проспект Жукова=Станция будет находится на пересечении проспекта Дзержинского с улицей Щорса.
Медвежино=Станция будет находится на пересечении проспекта Жукова с улицей Пономаренко.
Улица Притыцкого=Станция будет находится на пересечении проспекта Пушкина с улицей Притыцкого.
Проспект Машерова=Станция будет находится на пересечении Победителей с улицей Орловская.

[]