[Options]
AddToInfo=1
Caption=Interests
CityName=Montreal
StringToAdd='Interests:'

[1 GREEN ANGRIGNON - HONORÉ-BEAUGRAND]
Angrignon=Parc Angrignon
Monk=Centre hospitalier Ville Émard\nÉcole Dollard-des-Ormeaux\nÉcole St-Jean-de-Matha\nÉcole Honoré-Mercier
Jolicoeur=Académie Argyle\nCentre d'orientation et de formation des immigrants (C.O.F.I.)\nÉcole Coeur-Immaculé-de-Marie\nCentre St-Raphaël\nParc de-la-Vérendrye
Verdun=St. Willibrord Hospitality Center\nHôtel de ville de Verdun\nÉcole Levis-Sauvé\nRégie du logement\nCentre communautaire Marcel-Giroux
De L'Église=Santé et Bien-être social Canada\nCentre de services sociaux du Montréal Métropolitain b.s.s. Sud-Ouest\nCentre hospitalier de Verdun\nAuditorium de Verdun\nÉcole Notre-Dame-des-Sept-Douleurs\nParc Thérien
LaSalle=Centre d'accueil Réal-Morel\nPolyvalente Mgr Richard\nÉcole Notre-Dame-de-la-Paix
Charlevoix=Centre St-Charles\nCentre d'accueil Louis-Riel\nCarrefour d'éducation populaire\nServices juridiques communautaires de Pointe-St-Charles et de La Petite Bourgogne\nCentre St-Columba House\nService d'immatriculation des véhicules automobiles
Lionel-Groulx=Église St-Irénée\nFoyer Hongrois\nUnion United Church
Atwater=Place Alexis-Nihon\nHôpital Reddy Memorial\nHôpital de Montréal pour enfant\nWestmount Square\nCollège Dawson
Guy-Concordia=Canadian Centre for\nArchitecture\nCLSC Métro\nFaubourg Sainte-Catherine\nTour Guy\nConcordia University
Peel=Les Cours Mont-Royal\nAetna Canada\nLe 2000 Peel Iata\nMaison Sodarcan\nÉdifice Dominion Square\nYMCA de Montréal
McGill=Centre Eaton\nÉpargne placements Québec\nMaison des Coopérants\nPlace Montreal Trust\nPlace London Life\nPromenade de la Cathédrale\nLe Centre 2020 University\nLa Baie\nMaison Simons\nMcGill University
Place des Arts=Complexe Desjardins\nLe Directeur de l'état civil\n(De Bleury Nord Exit)\nGovernment of Canada\nHôtel Wyndham Montréal\nHydro-Québec\nMusée d'art contemporain\nPlace des Arts\nRégie de l'assurance maladie du Québec\n(De Bleury Nord Exit)\nUniversité du Québec à Montréal (UQAM)\npavillon Président-Kennedy\npavillon Chimie et biochimie\npavillon Arts IV\npavillon Sherbrooke
Saint-Laurent=Habitation Jeanne-Mance\nUQAM pavillon Ste-Catherine\nCégep du Vieux-Montréal\nCECI (Centre canadien d'études et de coopération internationale)\nMonument National (École nationale de théâtre)
Berri-UQAM=STM's Customer Services Centre\nCégep du Vieux-Montréal\nCinéma Quartier Latin\nCinémathèque Québecoise\nCinéRobothèque (NFB)\nLe Quartier latin\nPlace Dupuis\nRue Saint-Denis\nStation centrale d'autobus (Formerly Terminus Voyageur)\nThéâtre St-Denis\nUniversité du Québec à Montréal
Beaudry=Association coopérative d'économie familliale\nCentre Travail Québec\nMaison Radio-Canada
Papineau=Télé-Métropole\nSonolab\nÉdifice de la sécurite publique\nConfédération des syndicats nationaux\nTélé-Québec\nTéléport de Montréal
Frontenac=Place Frontenac\nMaison de la culture du Parc Frontenac\nÉcole Gédéon-Ouimet\nÉcole Jean-Baptiste-Meilleur\nÉcole St-Anselme\nParc et Jardins communautaires Médéric-Martin
Préfontaine=Centre hospitalier J.-Henri-Charbonneau\nCentre d'achats Maisonneuve\nSociété canadienne de la Croix-Rouge\nAréna et Parc Raymond-Préfontaine\nInstitut Teccart\nÉcole Notre-Dame de l'Assomption
Joliette=Cégep de Maisonneuve\nCLSC Hochelaga Maisonneuve\nLoisirs Notre-Dame de l'Assomption\nÉcole Ste-Jeanne-d'Arc\nParc Lalancette
Pie-IX=Stade Olympique\nBiodôme\nJardin botanique de Montréal\nLe château Dufresne\nHôpital St-Albert-le-Grand\nCentre Irénée-Lussier
Viau=Stade Olympique\nBiodôme\nAréna Maurice-Richard\nCentre Pierre-Charbonneau\nAréna YMCA\nParc Maisonneuve
Assomption=CLSC Olivier-Guimond\nHôpital Maisonneuve-Rosemont\nÉcole Marguerite-de-la-Jemmerais\nCentre d'accueil Foyer Rousselot\nComplexe Raycom\nLe Village Olympique
Cadillac=Centre hospitalier Grace Dart\nBanque fédérale de développement\nBureau du commissaire du travail\nService des sports et loisirs
Langelier=Centre commercial Domaine\nCentre d'emploi du Canada\nBibliothèque Langelier\nÉcole St-Donat\nÉcole Mgr Harold-Doran
Radisson=Place Versailles\nCentre de réadaptation Lucie-Bruneau\nHôpital Louis Hippolyte-Lafontaine
Honoré-Beaugrand=Centre Champlain\nCentre hospitalier juif de l'Espérance\nÉcole Mont-St-Antoine
                                         
[2 ORANGE CÔTE-VERTU - MONTMORENCY]
Côte-Vertu=Les galeries Norgate, shopping centre\nCégep Vanier, 821, boul. Sainte-Croix\nCLSC Saint-Laurent, 1055, boul. Saite-Croix
Du Collège=Cégep St-Laurent\nCégep Vanier\nÉcole Laurentide\nÉcole Hébert\nMusée d'art de Saint-Laurent
De La Savane=T.M.R. Shopping Centre
Namur=Hippodrome de Montréal\n(formerly Blue Bonnets Racetrack)\nAMT's park-and\nride facility\nSPCA (\nface="Arial, Helvetica, sans-serif" size="2">Society for the Prevention of Cruelty to\nAnimals)
Plamondon=Centre commercial Van Horne\nAcadémie Shadd\nÉcole St-Pascal Baylon\nÉcole Coronation\nÉcole Northmount\nCollège rabbinique du Canada
Côte-Sainte-Catherine=Hôpital général juif\nCentre communautaire juif\nCommunauté Sépharade du Québec - Centre d'accueil et d'information\nGrand rabbinat du Québec\nTalmud Torahs unis de Montréal
Snowdon=Bibliothèque Notre-Dame-de-Grâce
Villa-Maria=École Villa-Maria\nÉcole Notre-Dame-de-Grâce\nÉcole Marymount
Vendôme=Centre St-Raymond\nComplexe de santé Reine Élizabeth
Place-St-Henri=École Polyvalente St-Henri\nÉcole Ludger-Duvernay\nCollège Dawson\nInstitut technique Aviron\nAide juridique St-Henri
Lionel-Groulx=Église St-Irénée\nFoyer Hongrois\nUnion United Church
Georges-Vanier=Centre communautaire des Noirs\nCLSC St-Henri\nCentre communautaire Bon Pasteur
Lucien-l'Allier=Centre d'immigration du Canada\nCanadian Pacific Railway (head office)\nBell Centre\nGare Lucien-L'Allier - AMT's commuter trains\nUniversité Concordia's Visual Arts Building
Bonaventure=Access to the Underground Montréal\nMarie-Reine-du-Monde Cathedral\nCanadian Pacific Railway (head office)\nBell Centre\nÉcole de technologie supérieure\nCentral Station - Via Rail Canada\nGare Lucien-L'Allier - AMT's commuter trains\nWindsor Station\nLe Château Champlain Hotel\nLe 1000 de La Gauchetière\nICAO (International Civil Aviation Organization)\nPlace Bonaventure\nPlace du Canada\nPlace Ville-Marie\nCity of Montréal's Planetarium\nSTM (Head office)
Square-Victoria=Centre de commerce mondial de Montréal (accès intérieur)\nLe Curateur public, 600, boul. René-Lévesque\nPlace de la Cité internationale (accès intérieur)\nTour Banque Nationale (accès intérieur)\nTour Bell (accès intérieur)\nTour de la Bourse (accès intérieur)\nHôtel Delta Centre-ville (accès intérieur)\nHôtel Inter-continental (accès intérieur)\nPlace Victoria
Place-d'Armes=Palais des congrès\nComplexe Guy-Favreau\nBanque de Montréal (siège social)\nPalais de justice\nJournal La presse\nJournal The Gazette\nHôtel Intercontinental
Champ-de-Mars=Montreal City Hall\nMunicipal Court\nLe 333 St-Antoine (Ville de Montréal)\nHôpital St-Charles-Borromée\nHôpital St-Luc
Berri-UQAM=STM's Customer Services Centre\nCégep du Vieux-Montréal\nCinéma Quartier Latin\nCinémathèque Québecoise\nCinéRobothèque (NFB)\nLe Quartier latin\nPlace Dupuis\nRue Saint-Denis\nStation centrale d'autobus (Formerly Terminus Voyageur)\nThéâtre St-Denis\nUniversité du Québec à Montréal
Sherbrooke=Édifice C.H.Q. Gouvernement du Québec - Bureau des services sociaux Centre-Ville\nÉcole Cherrier\nHoliday Inn\nInstitut de tourisme et d'hôtellerie du Québec\nRue Saint-Denis
Mont-Royal=Avenue du Mont-Royal\nCentre communautaire Projet Changement\nÉcole Louis H. Lafontaine Arc-en-ciel\nLes jeunesses musicales du Canada\nMaison de la culture et bibliothèque Plateau Mont-Royal\nRue Saint-Denis\nTéluq (Université du Québec)
Laurier=Centre Champagnat (CSDM)\nÉcole Laurier\nÉcole nationale de théâtre\nÉcole supérieure de la danse du Québec\nPlaza Laurier\nTéluq (Université du Québec)
Rosemont=STM's Centre de transport Saint-Denis\nAide Juridique (Place de la mode)\nÉcole des métiers de l'automobile\nCour du Québec (Chambre de la jeunesse)\nCentre d'accueil Gouin-Rosemont
Beaubien=Académie Ste-Anne\nCLSC La Petite Patrie\nCour de la citoyenneté canadienne\nÉcole La Mennais\nPlaza St-Hubert
Jean-Talon=Marché Jean-Talon\nPlaza St-Hubert\nTour Jean-Talon
Jarry=Centre d'emploi du Canada\nÉcole Hélène-Boulé
Crémazie=Conseil scolaire de l'île de Montréal\nCommunautés culturelles et immigration du Québec\nÉcole St-Gérard\nGouvernement du Québec - Centre administratif
Sauvé=Centre d'accueil Louvain\nÉcole Marie-Anne\nÉcole Fernand-Seguin\nÉcole Christ-Roi\nMinistère des transports
Henri-Bourassa=Aréna Ahuntsic : 10560, rue Saint-Hubert\nBibliothèque Ahuntsic : 10300, rue Lajeunesse\nCégep de Bois-de-Boulogne (Bus 164 or 171)\nMaison de la culture Ahuntsic-Cartierville : 10300, rue Lajeunesse\nParc Ahuntsic Terminus Laval (Interior access)
                                         
[3 BLUE SNOWDON - SAINT-MICHEL]
Snowdon=Bibliothèque Notre-Dame-de-Grâce
Côte-des-Neiges=Centre hospitalier de St. Mary\nMaison de la culture Côte-des-Neiges\nCentre communautaire de la Côte-des-Neiges\nÉcole Notre-Dame-des-Neiges\nCollège Notre-Dame\nOratoire St-Joseph
Université-de-Montréal=Université de Montréal\nÉcole Polytechnique de Montréal\nÉcole des Hautes Études Commerciales\nCollège Jean-de-Brébeuf\nHôpital Ste-Justine
Édouard-Montpetit=CEPSUM\nÉcole de musique Vincent D'Indy\nUniversité de Montréal pavillon Marie-Victorin\nAcadémie Saint-Germain\nSalle Claude-Champagne
Outremont=Collège Stanislas\nÉcole Guy-Drummond\nÉcole Bais Esther\nTravail-Québec centre d'Outremont
Acadie=Centre commercial Place L'Acadie-Beaumont\nClinique René-Laennec
Parc=Télévision Quatre Saisons\nCLSC Parc Extension\nParc Jarry
De Castelnau=Parc Jarry\nÉcole Sainte-Cécile\nMarché Jean-Talon
Jean-Talon=Marché Jean-Talon\nPlaza St-Hubert\nTour Jean-Talon
Fabre=Hôpital Jean-Talon\nÉcole de Roberval\nCentre d'accueil Christophe-Colomb\nÉcole Saint-Gabriel-Lalemant
D'Iberville=École St-Barthélémy\nCentre des loisirs St-Barthélémy\nÉcole St-Mathieu
Saint-Michel=Bibliothèque Saint-Michel\nCentre administratif - Ville de Montréal\nÉcole Joseph-François-Perrault\nÉcole John F Kennedy\nParc François-Perrault
                                         
[4 YELLOW BERRI-UQAM - LONGUEUIL]
Berri-UQAM=STM's Customer Services Centre\nCégep du Vieux-Montréal\nCinéma Quartier Latin\nCinémathèque Québecoise\nCinéRobothèque (NFB)\nLe Quartier latin\nPlace Dupuis\nRue Saint-Denis\nStation centrale d'autobus (Formerly Terminus Voyageur)\nThéâtre St-Denis\nUniversité du Québec à Montréal
Jean-Drapeau=Biosphère\nLe Casino de Montréal\nLa Ronde\nParc\nJean-Drapeau\nRestaurant\nHélène-de-Champlain\nStewart Museum at the Fort on\nÎle Sainte-Hélène\nThéâtre de la Poudrière
Longueuil=Complexe Bienville\nComplexe St-Charles\nÉdifice Port-de-mer\nSandman Montreal-Longueuil Hotel\nTerminus Longueuil (RTL -\nRéseau de transport de Longueuil)\nUniversité de Sherbrooke
