[Options]
AddToInfo=1
Caption=Intersections
CityName=Montreal
StringToAdd='Intersections:'

[1 GREEN ANGRIGNON - HONORÉ-BEAUGRAND]
Angrignon=boul. des Trinitaires / av. Irwin\nboul. des Trinitaires / av. De Monts\nboul. des Trinitaires / av. Lamont
Monk=boul. Monk / rue Allard
Jolicoeur=rue Jolicoeur / boul. de La Vérendrye
Verdun=rue Verdun / av. Willibrord
De L'Église=av. Galt / rue Wellington\nav. de l'Église / rue Ross
LaSalle=rue Rushbrooke / av. Caisse
Charlevoix=rue Charlevoix / rue Centre
Lionel-Groulx=av. Atwater / rue St-Jacques\nav. Atwater / rue Lionel-Groulx\nav. Atwater / rue Delisle
Atwater=av. Atwater / boul. de Maisonneuve\nav. Atwater / rue Ste-Catherine\nav. Wood / boul. de Maisonneuve
Guy-Concordia=rue Guy / boul. de Maisonneuve\nrue St-Mathieu / boul. de Maisonneuve
Peel=rue Peel / boul. de Maisonneuve\nrue Stanley / boul. de Maisonneuve
McGill=boul. de Maisonneuve / av. Union\nboul. de Maisonneuve / av. McGill College
Place des Arts=boul. de Maisonneuve / rue Jeanne-Mance\nboul. de Maisonneuve / rue de Bleury
Saint-Laurent=boul. de Maisonneuve / rue St-Dominique
Berri-UQAM=rue Berri / boul. de Maisonneuve Est\nrue St-Denis / boul. de Maisonneuve Est\nrue St-Hubert / boul. de Maisonneuve Est\nrue Berri / rue Ste-Catherine Est\nrue St-Denis / rue Ste-Catherine Est
Beaudry=rue Ste-Catherine / rue Beaudry
Papineau=boul. de Maisonneuve / rue Cartier
Frontenac=rue Frontenac / rue Ontario Est
Préfontaine=rue Hochelaga / rue Moreau
Joliette=rue Joliette / rue Hochelaga
Pie-IX=boul. Pie-IX / av. Pierre-de-Coubertin
Viau=av. Pierre-de-Coubertin / rue Théodore
Assomption=boul. De L'Assomption / rue Chauveau
Cadillac=rue De Cadillac / rue Sherbrooke
Langelier=boul. Langelier / rue Sherbrooke
Radisson=rue Sherbrooke / rue Des Groseilliers
Honoré-Beaugrand=rue Sherbrooke / rue Honoré-Beaugrand
                                       
[2 ORANGE CÔTE-VERTU - MONTMORENCY]
Côte-Vertu=ch. Côte-Vertu / Boul. Décarie\nch. Côte-Vertu / rue Gohier\nboul. Décarie / rue Édouard-Laurin\nrue Gohier / rue Édouard-Laurin
Du Collège=rue Du Collège / boul. Décarie\nboul. Décarie / rue Cartier
De La Savane=boul. Décarie / rue de Sorel
Namur=boul. Décarie / rue Jean-Talon
Plamondon=av. Victoria / av. Plamondon\nav. Victoria / av. Van Horne
Côte-Sainte-Catherine=chemin de la Côte-Ste-Catherine / av. Victoria
Snowdon=chemin Queen-Mary / av. Westbury
Villa-Maria=boul. Décarie / av. Monkland
Vendôme=boul. de Maisonneuve / av. de Vendôme
Place-St-Henri=rue St-Ferdinand / rue St-Jacques
Lionel-Groulx=av. Atwater / rue St-Jacques\nav. Atwater / rue Lionel-Groulx\nav. Atwater / rue Delisle
Georges-Vanier=rue St-Antoine / boul. Georges-Vanier
Lucien-l'Allier=rue Lucien-L'Allier / av. Argyle
Bonaventure=rue de La Gauchetière Ouest / rue Peel\nrue Saint-Antoine Ouest / rue Peel
Square-Victoria=rue Belmont / Côte du Beaver Hall\nav. Viger / Côte du Beaver Hall\nrue St-Antoine / Square Victoria\nrue St-Jacques / Square Victoria
Place-d'Armes=rue St-Urbain / av. Viger
Champ-de-Mars=rue Sanguinet / av. Viger
Berri-UQAM=rue Berri / boul. de Maisonneuve Est\nrue St-Denis / boul. de Maisonneuve Est\nrue St-Hubert / boul. de Maisonneuve Est\nrue Berri / rue Ste-Catherine Est\nrue St-Denis / rue Ste-Catherine Est
Sherbrooke=rue Berri / rue Cherrier
Mont-Royal=av. du Mont-Royal / rue Berri
Laurier=av. Laurier / rue Rivard\nrue Berri / rue Gilford
Rosemont=boul. Rosemont / rue St-Valier
Beaubien=av. de Châteaubriand / rue Beaubien
Jean-Talon=rue Jean-Talon / rue St-Denis\nrue Jean-Talon / rue Berri\nrue Jean-Talon / rue Lajeunesse\nrue Jean-Talon / rue St-Vallier\nrue Jean-Talon / rue St-Hubert
Jarry=rue Jarry / rue Berri
Crémazie=boul. Crémazie / rue Berri
Sauvé=rue Sauvé / rue Berri
Henri-Bourassa=boul. Henri-Bourassa / rue Lajeunesse\nboul. Henri-Bourassa / rue Berri
                                       
[3 BLUE SNOWDON - SAINT-MICHEL]
Snowdon=chemin Queen-Mary / av. Westbury
Côte-des-Neiges=chemin de la Côte-des-Neiges / av. Lacombe
Université-de-Montréal=boul Édouard-Monpetit / av. Louis-Colin
Édouard-Montpetit=boul. Édouard-Monpetit / av. Vincent-D'Indy
Outremont=av. Van Horne / av. Wiseman
Acadie=boul. de l'Acadie / rue Beaumont
Parc=rue Hutchison / rue Jean-Talon
De Castelnau=rue De Castelnau / boul. St-Laurent
Jean-Talon=rue Jean-Talon / rue St-Denis\nrue Jean-Talon / rue Berri\nrue Jean-Talon / rue Lajeunesse\nrue Jean-Talon / rue St-Vallier\nrue Jean-Talon / rue St-Hubert
Fabre=rue Jean-Talon / rue Fabre\nrue Jean-Talon / rue Marquette
D'Iberville=rue Jean-Talon / av. Louis-Hébert\nrue Jean-Talon / rue D'Iberville
Saint-Michel=boul. St-Michel / boul. Shaughnessy\nboul. St-Michel / rue Everett\nboul. St-Michel / rue Jean-Talon
                                       
[4 YELLOW BERRI-UQAM - LONGUEUIL]
Berri-UQAM=rue Berri / boul. de Maisonneuve Est\nrue St-Denis / boul. de Maisonneuve Est\nrue St-Hubert / boul. de Maisonneuve Est\nrue Berri / rue Ste-Catherine Est\nrue St-Denis / rue Ste-Catherine Est
Jean-Drapeau=chemin MacDonald / rue Ste-Hélène
Longueuil=Place Charles Lemoyne / rue St-Charles
