[Options]
AddToInfo=1
Caption=Макет
CityName=Санкт-Петербург
Type=3dImage

[1]
Девяткино=Devyatkino.pm3d,DevyatkinoTrain.pms
Гражданский проспект=GrazhdanskyPr.pm3d
Академическая=Akademicheskaya.pm3d
Политехническая=Polytech.pm3d
Площадь Мужества=PlMuzhestva.pm3d
Лесная=Lesnaya.pm3d
Выборгская=Vyborgskaya.pm3d
Площадь Ленина=PlLenina.pm3d
Чернышевская=Chernyshevskaya.pm3d
Площадь Восстания=PlVosstania-Mayakovskaya.pm3d,Mayakovskaya.pms
Владимирская=Vladimirskaya-Dostoevskaya.pm3d,Dostoevskaya.pms
Пушкинская=PushkinskayaZvenigorodskaya.pm3d,Zvenigorodskaya.pms
Технологический институт-I=TechInstitut.pm3d,TechInstitut2.pms
Балтийская=Baltiyskaya.pm3d
Нарвская=Narvskaya.pm3d
Кировский завод=KirovskyZavod.pm3d
Автово=Avtovo.pm3d
Ленинский проспект=LeninskyPr.pm3d
Проспект Ветеранов=PrVeteranov.pm3d

[2]
Парнас=Parnas.pm3d
Проспект Просвещения=PrProsvescheniya.pm3d
Озерки=Ozerki.pm3d
Удельная=Udelnaya.pm3d
Пионерская=Pionerskaya.pm3d
Чёрная речка=ChernayaRechka.pm3d
Петроградская=Petrogradskaya.pm3d
Горьковская=Gorkovskaya.pm3d
Невский проспект=NevskiPr-GostinyDvor.pm3d
Сенная площадь=Sadovaya-SennayaPl.pm3d,Sadovaya.pms
Технологический институт-II=TechInstitut.pm3d,TechInstitut2.pms
Фрунзенская=Frunzenskaya.pm3d
Московские ворота=MoskVorota.pm3d
Электросила=Electrosila.pm3d
Парк Победы=ParkPobedy.pm3d
Московская=Moskovskaya.pm3d
Звёздная=Zvezdnaya.pm3d
Купчино=Kupchino.pm3d,KupchinoTrain.pms

[3]
Приморская=Primorskaya.pm3d
Василеостровская=Vasileostrovskaya.pm3d
Гостиный двор=NevskiPr-GostinyDvor.pm3d
Маяковская=PlVosstania-Mayakovskaya.pm3d,Mayakovskaya.pms
Площадь Александра Невского-I=AleksandraNevskogo.pm3d
Елизаровская=Elizarovskaya.pm3d
Ломоносовская=Lomonosovskaya.pm3d
Пролетарская=Proletarskaya.pm3d
Обухово=Obukhovo.pm3d
Рыбацкое=Rybatskoe.pm3d

[4]
Спасская=Sadovaya-SennayaPl.pm3d,Sadovaya.pms
Достоевская=Vladimirskaya-Dostoevskaya.pm3d,Dostoevskaya.pms
Лиговский проспект=LigovskiyPr.pm3d
Площадь Александра Невского-II=AleksandraNevskogo.pm3d
Новочеркасская=Novocherkasskaya.pm3d
Ладожская=Ladozhskaya.pm3d
Проспект Большевиков=PrBolshevikov.pm3d
Улица Дыбенко=UlDybenko.pm3d

[5]
Комендантский проспект=KomendantskyPr.pm3d
Старая Деревня=StarayaDerevnya.pm3d
Крестовский остров=KrestovskiyOstrov.pm3d
Чкаловская=Chkalovskaya.pm3d
Спортивная=Sportivnaya.pm3d
Адмиралтейская=Admiralteyskaya.pm3d
Садовая=Sadovaya-SennayaPl.pm3d,Sadovaya.pms
Звенигородская=PushkinskayaZvenigorodskaya.pm3d,Zvenigorodskaya.pms
Обводный канал=ObvodnyCanal.pm3d
Волковская=Volkovskaya.pm3d
;Бухарестская
Международная=Mezhdunarodnaya.pm3d
