[Options]
AddToInfo=1
CityName=Санкт-Петербург
MenuName=Разное\Банкоматы Балтийского банка
Caption=Банкоматы Балтийского банка
StringToAdd='  Банкоматы Балтийского банка: '
MenuImage=Bank_Baltiyskiy_logo.bmp

[1]
Девяткино=на входе, перед турникетами
Гражданский проспект=в метро, 1-й банкомат – на входе слева, 2-й и 3-й банкоматы –  перед турникетами\nПросвещения пр., д. 80, к.2 (гипермаркет «О’Кей»)
Академическая=в метро, 1-й банкомат - на входе в метро, в стене, 2-й банкомат – на выходе справа, 3-й банкомат - перед турникетами\nГражданский пр., д. 36 (отделение «Академическое»)\nГражданский пр., д. 28 (ГИМОП, в холле)
Политехническая=в метро, 2 банкомата на входе, перед турникетами\nПолитехническая ул., д. 29 (СПбГПУ, 2 банкомата: в 1-м корпусе, в холле; в главном корпусе, в холле)
Площадь Мужества=2 банкомата на входе, перед турникетами
Лесная=в метро, на входе, слева\nКантемировская ул., д. 11/13 (завод им. М. И. Климова)\nКантемировская ул., д. 37 («Мебель-Сити», в холле)\nБольшой Сампсониевский пр., д. 88 (отделение «Кантемировское»)
Выборгская=на входе, слева
Площадь Ленина=в метро, на входе (Финляндский вокзал), напротив турникетов, и на выходе (ул. Боткина), у турникетов\nЛенина пл., д. 6 (Финляндский вокзал, 2 банкомата: в зале ожидания и в кассовом зале)\nБоткинская ул., д. 15 (отделение «Боткинская, 15»)\nБоткинская ул., д. 19/21 (3-й факультет Военно-Медицинской Академии)
Чернышевская=на входе, справа
Площадь Восстания=в метро, (ул. Восстания), на входе, справа, (Московский вокзал), вход с Лиговского пр., 2 банкомата: на входе и на выходе слева\nНевский пр., д. 85 (отделение «Лиговское», Московский вокзал), 3 банкомата (при входе в «Световой зал», справа и слева)
Владимирская=в метро, на выходе, за турникетами\nЗагородный пр., д. 18/2 (отделение «Владимирское»)\nЛомоносова ул., д. 9 (СПб ГУ Низкотемпературных и Пищевых технологий)
Пушкинская=Загородный пр., д. 52 (Витебский вокзал, 2 банкомата: 1-й этаж, кассовый зал, справа и слева)
Технологический институт-I=в метро, 1-й банкомат – в переходе между  станциями, 2-й банкомат – на входе в метро, 3-й банкомат – на выходе, справа\n1-я Красноармейская ул., д. 13 (Балтийский ГТУ «Военмех» им. Д. Ф. Устинова)\nИзмайловский пр., д. 4 («ТрансМашПроект»)
Балтийская=в метро, на входе, слева\nОбводного канала наб., д. 120 (Балтийский вокзал, 3 банкомата: экспресс-кассы; пригородные кассы, слева и справа)\nОбводного канала наб., д. 118, лит. Т (гипермаркет «Лента»)
Нарвская=на выходе, справа
Кировский завод=в метро, на входе, за турникетами\nВаси Алексеева ул., д. 6, лит. А (ТЦ «Румба»)\nСтачек пр., д. 45 (отделение «Кировское»)
Автово=1-й - в кассовом зале, слева, 2-й - на входе, слева
Ленинский проспект=на входе, справа
Проспект Ветеранов=в метро, на выходе, справа\nДачный пр., д. 17, корп. 3 (отделение «Дачный, 17»)\nВетеранов пр., д. 50 (магазин «Дикси»)

[2]
Парнас=платформа прибытия
Проспект Просвещения=в метро, на входе, слева\nХошимина ул., д. 9, к. 1 (отделение «Северное»)
Озерки=в метро, на выходе, слева\nЭнгельса пр., д. 113, к. 1 (ТЦ «Бада Бум»)\nЭнгельса пр., д. 117 (СПб ГУЗ «Детская городская поликлиника №71)\nСикейроса ул., д. 10, к. 2 (Женская консультация №22)
Удельная=1-й банкомат – на входе в метро, 2-й банкомат – на улице, в стене здания
Пионерская=в метро, 2 банкомата на входе перед турникетами\nИспытателей пр., д. 13 (универсам «Серебристый»)\nАэродромная ул., д. 4 (ФГОУ «Государственный региональный образовательный центр», на входе справа)
Чёрная речка=в метро, на входе, перед турникетами\nСавушкина ул., д. 7 (отделение «Приморское»)
Петроградская=Большая Пушкарская ул., д. 47 (отделение «Петроградское»)\nЛьва Толстого ул., д. 17 (1-й Медицинский Университет, в холле, перед охраной)\nЛьва Толстого ул., д. 6/8 (1-й Медицинский Университет, в холле 1-го этажа)
Горьковская=Кронверкский пр., д. 13/2 (ресторан «Евразия»)\nАлександровский парк, д. 5 (ГОУ ВПО «Российская академия правосудия»)\nАлександровский парк, д. 7 (ГУ «Военно-исторический музей артиллерии, инженерных войск и связи»)\nБольшая Посадская ул., д. 9 («Электроприбор», в холле 2-й проходной)\nКуйбышева ул., д. 2-4 (Государственный музей политической истории России)\nКронверкский пр., д. 49 (ЛИТМО, центральный вход)
Невский проспект=в метро, внизу у эскалатора\nНевский пр., д. 28, Дом Зингера (отделение «Невский, 28»)
Сенная площадь=в метро,на входе, слева\nСадовая ул., д. 34 (валютный банкомат)\nМосковский пр., д. 9 (ПГУПС, в центральном холле, слева)\nМучной пер., д. 2 (отделение «Центральное»)\nНаб. реки Фонтанки, д. 117 (Бизнес-центр)
Технологический институт-II=в метро, 1-й банкомат – в переходе между  станциями, 2-й банкомат – на входе в метро, 3-й банкомат – на выходе, справа\n1-я Красноармейская ул., д. 13 (Балтийский ГТУ «Военмех» им. Д. Ф. Устинова)\nИзмайловский пр., д. 4 («ТрансМашПроект»)
Фрунзенская=на входе, перед турникетами
Московские ворота=в метро, на выходе, у турникетов\nМосковский пр., д. 95 (УВД по Московскому району г. Санкт-Петербурга, круглосуточно, общего доступа)
Электросила=Московский пр., д. 164 (отделение «Московское»)\nМосковский пр., д. 137 (гипермаркет «О’Кей»)
Парк Победы=в метро, на входе, справа\nМосковский пр., д. 190 (мебельный салон 1-й мебельной фабрики)
Московская=в метро, выход на ул. Авиационную\nМосковский пр., д. 193 (отделение «Московский, 193»)
Звёздная=на входе и на выходе, справа
Купчино=в метро, 2 банкомата на платформе прибытия, 3-й на входе, до турникета\nМалая Балканская, д. 27 (гипермаркет «О’Кей»)\nДунайский пр., д. 31, к.1 (отделение «Купчинское»)

[3]
Приморская=в метро, на входе, перед турникетами\nБеринга ул., д. 38 (Институт Арктики и Антарктики, вестибюль)
Василеостровская=в метро, на входе, справа\n7-я линия В.О., д. 54 (отделение «Василеостровское»)\nБольшой пр. В.О., д. 18 (ТЦ «Андреевский»)
Гостиный двор=в метро, на входе, справа от турникетов\nНевский пр., д. 28, Дом Зингера (отделение «Невский, 28»)
Маяковская=на входе, справа
Площадь Александра Невского-I=в метро, 1-й банкомат – в переходе между станциями, 2-й банкомат – на входе, перед турникетами\nМиргородская ул., д. 24-28 (СПб ГОУ СПО «Колледж строительной индустрии и городского хозяйства»)
Елизаровская=на выходе из метро
Ломоносовская=в метро, на входе, справа\nПолярников ул., д. 8 (отделение «Невское»)
Пролетарская=Чернова ул., д. 2, т. Б. (магазин «Дикси»)\nГрибакиных ул., д. 5 (Невское РУВД, круглосуточно, общего доступа)
Обухово=на входе, перед турникетами
Рыбацкое=в метро,1-й банкомат - вестибюль платформы отправления, 2-й банкомат – платформа прибытия\nПрибрежная ул., д. 13 (супермаркет «О'КЕЙ»)

[4]
Достоевская=в метро, на входе и на выходе, у турникетов\nЗагородный пр., д. 18/2 (отделение «Владимирское»)\nЛомоносова ул., д. 9 (СПб ГУ Низкотемпературных и Пищевых технологий)
Лиговский проспект=на входе и на выходе, у турникетов
Площадь Александра Невского-II=в метро, 1-й банкомат – в переходе между станциями, 2-й банкомат – на входе, перед турникетами\nМиргородская ул., д. 24-28 (СПб ГОУ СПО «Колледж строительной индустрии и городского хозяйства»)
Новочеркасская=на выходе, у турникетов 
Ладожская=в метро, 2 банкомата на выходе у эскалатора\nЛадожский вокзал, 2 банкомата: на входе в здание вокзала, слева и справа\nЗаневский пр., д. 73 (отделение «Ладожское»)\nЗаневский пр., д. 65, к. 1 (гипермаркет «О’Кей», 2 банкомата, на входе, справа)
Проспект Большевиков=в метро, на выходе справа\nБольшевиков пр., д. 6 (универсам «Невский»)
Улица Дыбенко=в метро, на выходе, у турникетов\nБольшевиков пр., д. 10 (гипермаркет «О’Кей»)

[5]
Комендантский проспект=в метро, на выходе, слева\nГаккелевская ул., д. 32 (отделение «Комендантское»)\nКомендантский пр., д. 11 (ТЦ «MILLER»)\nКомендантский пр., д. 24/1 (универсам «Голубой»)\nСтародеревенская ул., д. 36 (ТЦ «Крокус»)
Старая Деревня=в метро, 1-й на выходе, справа, 2-й на входе, слева\nМебельная ул., д. 1 («Мебель-сити»)\nСавушкина ул., д. 83 (Администрация Приморского района)
Крестовский остров=на выходе, слева
Чкаловская=в метро, на входе, в стене здания\nБольшая Зеленина ул., д. 8 (отделение «Большая Зеленина, 8»)\nПионерская ул., д. 28 (общежитие ВКА им. Можайского, в холле у будки дежурного)\nКрасного Курсанта ул., д. 16 (ВКА им.Можайского, 1-й КПП)
Спортивная=на выходе, у турникетов
Садовая=в метро,1-й на входе, перед турникетами, 2-й на выходе, справа\nСадовая ул., д. 34 (валютный банкомат)\nМосковский пр., д. 9 (ПГУПС, в центральном холле, слева)\nМучной пер., д. 2 (отделение «Центральное»)\nНаб. реки Фонтанки, д. 117 (Бизнес-центр)
Звенигородская=Загородный пр., д. 52 (Витебский вокзал, 2 банкомата: 1-й этаж, кассовый зал, справа и слева)
