[Options]
AddToInfo=1
Caption=Схема
CityName=Ташкент
Type=Image

[Chilonzor]
Olmazor=Olmazor.vec
Chilonzor=Chilonzor.vec
Mirzo Ulug'bek=MirzoUlugbek.vec
Hamza=Hamza.vec
Milliy Bog'=MilliyBog.vec
Bunyodkor=Bunyodkor.vec
Paxtakor=Paxtakor-AlisherNavoiy.vec
Mustaqillik Maydoni=MustaqillikMaydoni.vec
Amir Temur Xiyoboni=AmirTemurXiyoboni-YunusRajabiy.vec
Hamid Olimjon=HamidOlimjon.vec
Pushkin=Pushkin.vec
Buyuk Ipak Yo'li=BuyukIpakYoli.vec

[O'zbekiston]
Beruniy=Beruniy.vec
Tinchlik=Tinchlik.vec
Chorsu=Chorsu.vec
G'afur G'ulom=GafurGulom.vec
Alisher Navoiy=Paxtakor-AlisherNavoiy.vec
O'zbekiston=Ozbekiston.vec
Kosmonavtlar=Kosmonavtlar.vec
Oybek=Oybek-MingOrik.vec
Toshkent=Toshkent.vec
Mashinasozlar=Mashinasozlart.vec
Do'stlik=Dostlik.vec

[Yunusobod]
Ming O'rik=Oybek-MingOrik.vec
Yunus Rajabiy=AmirTemurXiyoboni-YunusRajabiy.vec
Abdulla Qodiriy=AbdullaQodiriy.vec
Minor=Minor.vec
Bodomzor=Bodomzor.vec
Habib Abdullayev=HabibAbdullayev.vec
;Yunus-Obod=
;Turkiston=

