[Options]
AddToInfo=1
CityName=Минск
MenuName=Развлечения\Парки и места отдыха
Caption=Парки и места отдыха
StringToAdd=
MenuImage=Parks.bmp

[Московская]
Восток=Парк у Национальной библиотеки Республики Беларусь\nСлепянская водная система
Парк Челюскинцев=Парк Челюскинцев, атракционы\nБотанический сад
Московская=Детская железная дорога
Октябрьская=Парк имени Янки Купалы\nЦентральный сквер\nЦирк (просп. Независимости, 32, т. 226-10-08, 227-22-45, т. 227-78-42)
Академия наук=Здания Академии наук и Белорусского национального технического университета - памятники архитектуры XX в.
Площадь Победы=Центральный детский парк имени Горького, атракционы\nПланетарий (т. 236-33-64)\nПрокат лодок и катамаранов на реке Свислочь
Площадь Якуба Коласа=Рекреационная зона на площади Якуба Коласа\nБульвар В. Мулявина (рекреационная зона)
Площадь Ленина=Площадь Независимости - одна из самых больших в Европе\nРекреационная зона во внутреннем дворике БГУ\nМихайловский сквер (рекреационная зона)
Уручье=Парк "Уручье"
Борисовский тракт=Лесопарк

[Автозаводская]
Партизанская=Парк имени 50-летия Октября
Пролетарская=Парк им. 40-летия Октября, живописная набережная реки Свислочь на ул. Пулихова\nАнтоновский парк
Немига=Исторический центр города: Верхний город, Троицкое предместье, Раковское предместье, Ратуша, Торговые ряды, Гостинный двор\nСквер им. А.С. Пушкина (летом и осенью устраиваются выставки цветочных композиций)\nСендайский сквер\nСтепановский сад\nСквер Сторожёвка\nПереспенский сквер\nПрокат лодок и катамаранов на реке Свислочь
Купаловская=Центральный сквер
Спортивная=Парк "Тивали"
Автозаводская=Сквер "Пионерский"

[Столбцовское направление]
Минск-Пассажирский=Площадь Независимости - одна из самых больших в Европе\nРекреационная зона во внутреннем дворике БГУ\nМихайловский сквер (рекреационная зона)
Курасовщина=Лесопарк "Курасовщина", водохранилище Лошица

[Молодечненское направление]
Минск-Пассажирский=Площадь Независимости - одна из самых больших в Европе\nРекреационная зона во внутреннем дворике БГУ\nМихайловский сквер (рекреационная зона)
Лебяжий=Биологический заказник "Лебяжий" - место гнездования некоторых редких видов птиц

[Борисовское направление]
Минск-Пассажирский=Площадь Независимости - одна из самых больших в Европе\nРекреационная зона во внутреннем дворике БГУ\nМихайловский сквер (рекреационная зона)
Минск-Восточный=Парк им. 40-летия Октября, живописная набережная реки Свислочь на ул. Пулихова\nАнтоновский парк
Степянка=Лесопарк "Степянка"

[Осиповичское направление]
Минск-Пассажирский=Площадь Независимости - одна из самых больших в Европе\nРекреационная зона во внутреннем дворике БГУ\nМихайловский сквер (рекреационная зона)
Лошица=Лошицкий усадебно-парковый комплекс

[Детская ж/д.]
Заслоново=Парк Челюскинцев, атракционы\nБотанический сад\nДетская железная дорога
Сосновый Бор=Лесопарк "Степянка"

