[Options]
AddToInfo=1
Caption=Схема
CityName=Минск
;MenuName=Другое\Схемы
Type=Image

[Московская]
;Малиновка=
Петровщина=Petrovschina.vec
Михалово=Mihalovo.vec
Грушевка=Grushevka.vec
Институт Культуры=InstitutKultury.vec
Площадь Ленина=PlLenina.vec
Октябрьская=Okt-Kupalovskaya.vec
Площадь Победы=PlPobedy.vec
Площадь Якуба Коласа=PlYakubaKolasa.vec
Академия наук=AkademiyaNauk.vec
Парк Челюскинцев=ParkCheluskintsev.vec
Московская=Moskovskaya.vec
Восток=Vostok.vec
Борисовский тракт=BorisovskiyTrakt.vec
Уручье=Uruchye.vec

[Автозаводская]
Могилевская=Mogilevskaya.vec
Автозаводская=AvtozavodskayaSt.vec
Партизанская=Partizanskaya.vec
Тракторный завод=TraktornyZavod.vec
Пролетарская=Proletarskaya.vec
Первомайская=Pervomayskaya.vec
Купаловская=Okt-Kupalovskaya.vec
Немига=Nemiga.vec
Фрунзенская=Frunzenskaya.vec
Молодежная=Molodezhnaya.vec
Пушкинская=Pushkinskaya.vec
Спортивная=Sportivnaya.vec
Кунцевщина=Kuntsevschina.vec
Каменная Горка=KamennayaGorka.vec

[Молодечненское направление]
Минск-Северный=Molodezhnaya.vec
