[Options]
AddToInfo=1
Caption=Информация о выходах
CityName=Ankara
;StringToAdd='  '

[Metro]
Batikent=Информация об этой станции временно отсутствует.
Ostim=Информация об этой станции временно отсутствует.
Macuncoy=Информация об этой станции временно отсутствует.
Hastane=Выход к улицам Ivedic Cadde, Vatan Caddesi, Bagdat Cadde.
Demetevler=Выход к жилому району Demetevler, к улицам Ivedic Cadde, Vatan Caddesi, к улицам Baris Cadde, Suadiye Cadde. 
Yenimahalle=Выход к жилому району Yenimahalle, к улицам Ivedic Cadde, Bankacilar Sokak, Arif Hikmet Sokak, Ragip Tuzun Cadde, Carsi Cadde. 
Ivedik=Выход к улицам Ivedic Cadde, Cem Ersever Caddesi, Esref Bitlis Caddesi, Istanbul Cadde, Yahya Kemal Cadde.
Akkopru=Выход к улицам Istanbul Cadde, Turgut Ozal Bulvari, Konya Devlet Yolu, Sebzebahceleri Caddesi, Hipodrom Caddesi, к жилым районам Akkopru и Varlik Mahalle.
Kultur=Выход к улицам Istanbul Cadde, Sebzebahceleri Caddesi, Hipodrom Caddesi, Kazim Karabekir Cadde, Ruzgarli Cadde.
Ulus= Выход к улицам Cumhuriyet Bulvari, Istanbul Cadde, Istiklal Cadde, Ruzgarli Cadde, Ataturk Bulvari, Talatpasa Bulvari, Saygun Bulvari, к административным районам Ulus и Samanpazari.\n\nПереход на станцию GAR железной дороги TCDD.
Sihhiye=Выход к улицам Strazburg Cadde, Celal Bayar Bulvari, Cemal Gursel Bulvari, Necatibey Cadde, Ataturk Bulvari, Mithat Pasa Caddesi, Libya Cadde, к административному району Sihhiye.\n\nПереход на станцию Yenisehir железной дороги TCDD.
Kizilay=Выход к улицам Gazi Mustafa Kemal Bulvari, Ziya Gokalp Cadde, Ataturk Bulvari, Mithat Pasa Caddesi, Necatibey Cadde, Kumrular Sokak, Yahya Galip Cadde, Mesrutiyet Cadde, Mudafaa Cadde.\n\nПереход на станцию Kizilay линии Ankaray.

[Ankaray]
ASTI=Выход к автостанции Sehirlerarasi Otobus Terminali, к улицам Konya Devlet Yolu, Ismet Inonu Bulvari, Biskek Caddesi, Bosna Hersek Caddesi, к жилым районам Emek и Bestepe Mahalle.
Emek=Выход к жилым районам Emek и Bestepe Mahalle, к улицам Konya Devlet Yolu, Biskek Caddesi, Alparslan Turkes Caddesi.
Bahcelievler=Выход  к жилому району Bestepe Mahalle, к улицам Konya Devlet Yolu, Biskek Caddesi, Alparslan Turkes Caddesi, Kazakstan Caddesi.
Besevler=Выход к жилому району Besevler, к улицам Do Gol Caddesi, Maresal Fevzi, Muammer Yasar Bastanci Cadde, Konya Devlet Yolu, Azerbaygan Caddesi, Muammer Aksoy Caddesi, Taskent Caddesi, к площади Cahar Dudayev Meydani.
Tandogan=Выход к площади Tandogan Meydani, к улицам Celal Bayar Bulvari, Do Gol Caddesi, Kazim Karabekir Cadde, Hipodrom Caddesi, Cumhuriyet Bulvari, Gazi Mustafa Kemal Bulvari, Turgut Reis Cadde, Genclik Cadde.\n\nПереход на станцию GAR железной дороги TCDD.
Maltepe=Выход к улицам Gazi Mustafa Kemal Bulvari, Celal Bayar Bulvari, Turgut Reis Cadde.\n\nПереход на станцию GAR железной дороги TCDD.
Demirtepe=Выход к улицам Gazi Mustafa Kemal Bulvari, Strazburg Cadde, Suleyman Bey Sokak, Gonenc Sokak, Necatibey Cadde.
Kizilay=Выход к улицам Gazi Mustafa Kemak Bulvari, Ziya Gokalp Cadde, Ataturk Bulvari, Mithat Pasa Caddesi, Necatibey Cadde, Kumrular Sokak, Yahya Galip Cadde, Mesrutiyet Cadde, Mudafaa Cadde.\n\nПереход на станцию Kizilay линии Metro.
Kolej=Выход к улицам Ziya Gokalp Cadde, Libya Cadde, Mahmut Esat Bozkurt Cadde, Incesu Cadde, Mithat Pasa Caddesi, Baglar Cadde, Mesrutiyet Cadde, к административному району Kurtulus.
Kurtulus=Выход к административным районам Kurtulus и Cebesi, к улицам Ziya Gokalp Cadde, Cemal Gursel Cadde, Kibris Cadde.
Dikimevi=Выход к административным районам Dikimevi и Dortyol, к площади Dikimevi Meydani, к улицам Mamak Cadde, Cemal Gursel Cadde, Munzeviler Caddesi, Gaziler Sokak, Pilevne Cadde, Talatpasa Bulvari, Tipfakultesi Cadde.\n\nПереход на станцию Cebesi железной дороги TCDD.

[TCDD]
Behicbey=Информация об этой станции временно отсутствует.
Marsandiz=Информация об этой станции временно отсутствует.
MotorFab=Выход к заводу Turk Traktor Fab.
Gazi=Выход к лесному массиву Ataturk Orman Giftligi, к улицам Alparslan Turkes Caddesi, Silahtar Cadde, Sogutozu Cadde.
Gazi mah=Выход к лесному массиву Ataturk Orman Giftligi, к жилым районам Gazi Mahalle и Emniyetevleri Mahalle, к улице Silahtar Cadde.
Hipodrom=Выход к улицам Konya Devlet Yolu, Silahtar Cadde, Bandirma Sokak, Celal Bayar Bulvari, Hipodrom Caddesi, к жилому району Emniyetevleri Mahalle. 
Gar=Выход к улицам  Celal Bayar Bulvari, Hipodrom Caddesi, Kazim Karabekir Cadde, Cumhuriyet Bulvari, Gazi Mustafa Kemal Bulvari, Talatpasa Bulvari.\n\nПереход на станции Tandogan и Maltepe линии Ankaray, станцию Ulus линии Metro.
Yenisehir=Выход к улицам Strazburg Cadde, Celal Bayar Bulvari, Cemal Gursel Bulvari, Necatibey Cadde, Ataturk Bulvari, Mithat Pasa Caddesi, Libya Cadde, Adnan Saygun Caddesi, к административному району Sihhiye.\n\nПереход на станцию Sihhiye линии Metro.
Cebeci=Выход к административным районам Dikimevi и Dortyol, к улицам Mamak Cadde, Cemal Gursel Cadde, Munzeviler Caddesi, Gaziler Sokak, Pilevne Cadde, Talatpasa Bulvari, Tipfakultesi Cadde.\n\nПереход на станцию Dikimevi линии Ankaray. Demirlibahce=Выход к улицам Arif Yaldiz Caddesi, Pilevne Cadde, Bentderesi Cadde, Mamak Cadde, Tipfakultesi Cadde, Gaziler Sokak.
Gulveren=Информация об этой станции временно отсутствует.

